10 2
XXXX..XXXX
..........
..........
...$..$...
..XXXXXX..
...H..H...
..........
..........
XXX....XXX
..........
..........
..........
..........
..........
..........
..........
..........